0000000000000000000000000000000000000000
0111111111111111211111111111111111311110
0113111111411111111111112118111111111110
0111111111111111511111111611111151111110
0211112111111110111111311601111111111110
0111111111111110111111111101111111001110
0111110011111111111111111101111101111110
0116111111111110111111111111112101111110
0111141111131110111111111111811111311110
0311111111111111111113111111111111111110
0111111111111111111111111111121111111110
0111115111211111111111111111111111114110
0111111111111111211111111161111151111110
0112181111111111111111110000011111111110
0113111000111111111111111111011111111110
0111111111112111111113111111011111111110
0111111111111111111111111111011111111110
0111111111111141111111111111111111111110
0111111111111111111111111111111111111310
0000000000000000000000000000000000000000